1111111111111
1D01000000C01
1000111111001
1D00P1EE00001
1111111111111
100011EE00001
1111111111111
1111111111111