1111111111111111111111111111
11111111110000C0001111111111
11111111000001110C0111111111
1111110000001111000111111111
11111D00C0001111000111111111
11111111C11111110C011111C111
1000000D0000C011000111110111
10C000000D000011000111100011
1000000000000011000111000001
10C0000000000011000110000001
10000000D0000011000100000001
11111110C0111111000000000001
11111110C0111111D00000000001
11111110C0111111000000000001
11111110C0111111000000000001
11111110C0111111D00000000001
11111110C0111111000000000001
11111110P0111111111110111111
1111111111111111D00000000001
11111111E1111111000000000001
1000000000000000000000000001
10D000000000000D000000000001
10000000000000000000000000C1
10000000000D0000000000000001
100C000000000000000000000001
1111111111111111111111111111