111111111111111
1111111E1111111
1000000C0000001
100001000100001
10D0010C0100D01
100D0100010D001
1000D10P01D0001
100C01111100C01
111111111111111
